2018-06-06 13:18:46,https://www.facebook.com/,2460,255,370,1140,1759,36,6020
2018-06-06 13:18:51,https://twitter.com/,264,115,232,1012,865,0,2488
2018-06-06 13:18:52,https://www.google.com/,380,101,252,777,1162,35,2707
2018-06-06 13:19:00,https://www.youtube.com/,349,70,526,1347,2693,10,4995
2018-06-06 13:19:08,https://www.linkedin.com/,887,208,120,1660,375,117,3367
2018-06-06 13:19:15,https://wordpress.org/,439,37,401,1280,3136,0,5293
2018-06-06 13:19:20,https://www.instagram.com/,1726,757,308,2329,536,14,5670
2018-06-06 13:19:27,https://www.pinterest.com/,811,373,39,952,8418,284,10877
2018-06-06 13:19:29,https://www.wikipedia.org/,1040,35,470,3360,351,0,5256
2018-06-06 13:19:32,https://www.blogger.com/,1619,31,300,2012,607,0,4569
2018-06-06 13:19:36,https://wordpress.com/,965,46,1164,589,5715,156,8635
2018-06-06 13:19:48,https://www.adobe.com/,609,0,454,6268,5177,333,12841
2018-06-06 13:20:03,https://www.apple.com/,645,30,419,5464,1197,60,7815
2018-06-06 13:20:08,https://www.tumblr.com/,1096,113,430,10262,809,24,12734
2018-06-06 13:20:19,https://www.amazon.com/,971,119,639,4565,1516,38,7848
2018-06-06 13:20:19,https://www.youtube.com/,1229,86,534,8216,8659,3,18727
2018-06-06 13:20:25,https://goo.gl/,1360,65,510,2252,3464,2,7653
2018-06-06 13:20:37,https://www.microsoft.com/,1635,188,723,3501,1499,33,7579
2018-06-06 13:20:47,https://vimeo.com/,1339,136,1607,5460,9868,26,18436
2018-06-06 13:21:04,https://www.flickr.com/,1717,118,758,1130,12094,19,15836
2018-06-06 13:21:19,https://www.godaddy.com/,2337,219,550,700,1026,33,4865
2018-06-06 13:21:30,https://www.buydomains.com/,5298,1436,1419,5744,12531,17,26445
2018-06-06 13:21:37,https://vk.com/,3006,169,3577,7376,5663,312,20103
2018-06-06 13:21:41,https://www.w3.org/,4890,112,5003,1053,2403,1,13462
2018-06-06 13:21:42,http://t.co/,633,96,2821,23,516,0,4089
2018-06-06 13:21:46,http://baidu.com/,57,135,2236,77,166,0,2671
2018-06-06 13:21:50,http://www.baidu.com/,768,330,641,2766,634,16,5155
2018-06-06 13:21:51,https://www.reddit.com/,3389,744,3712,1769,22386,46,32046
2018-06-06 13:22:02,http://europa.eu/,9,20,2267,1041,2357,4,5698
2018-06-06 13:22:06,https://www.nytimes.com/,3237,171,2324,14322,15872,44,35970
2018-06-06 13:22:07,https://www.gov.uk/,4854,80,686,1717,2243,1,9581
2018-06-06 13:22:24,http://statcounter.com/,78,320,2228,2815,2733,6,8180
2018-06-06 13:22:28,https://www.weebly.com/,2387,132,444,4068,8404,1,15436
2018-06-06 13:22:30,https://www.blogger.com/,3733,125,739,1713,560,0,6870
2018-06-06 13:23:00,https://soundcloud.com/,2217,178,848,4799,27943,1,35986
2018-06-06 13:23:02,https://www.mozilla.org/,6282,1572,15887,886,1476,3,26106
2018-06-06 13:23:03,https://github.com/,2205,77,1927,17302,3424,2,24937
2018-06-06 13:23:03,https://www.google.de/,1667,12568,1445,1545,5665,59,22949
2018-06-06 13:23:16,https://yandex.ru/,4178,342,2651,7613,2168,14,16966
2018-06-06 13:23:17,https://www.jimdo.com/,2181,187,939,3743,8699,4,15753
2018-06-06 13:23:27,https://myspace.com/,8548,333,2045,9405,20878,87,41296
2018-06-06 13:23:28,https://www.bluehost.com/,4478,987,3203,2249,2840,35,13792
2018-06-06 13:23:32,https://wordpress.com/,4814,779,1217,738,12301,447,20296
2018-06-06 13:23:41,https://www.addthis.com/,1722,1,1142,1591,6209,213,10878
2018-06-06 13:24:00,http://en.gravatar.com/,1554,142,800,2953,851,0,6300
2018-06-06 13:24:00,https://www.google.co.jp/,7039,93,3014,995,4443,100,15684
2018-06-06 13:24:01,https://www.nih.gov/,4861,78,1189,4859,2455,33,13475
2018-06-06 13:24:07,https://www.wix.com/,4629,104,3005,4402,10885,2,23027
2018-06-06 13:24:08,http://ascii.co.uk/,277,111,2308,1572,14876,24,19168
2018-06-06 13:24:13,https://www.paypal.com/,4526,327,940,940,2546,101,9380
2018-06-06 13:24:13,https://outlook.live.com/,1723,97,1261,3028,2090,0,8199
2018-06-06 13:24:30,https://www.elegantthemes.com/,2833,54,758,1039,1952,26,6662
2018-06-06 13:25:03,https://www.123-reg.co.uk/,2407,10,1867,670,5615,704,11273
2018-06-06 13:25:06,https://www.tripadvisor.com/,1734,314,786,1402,6972,285,11493
2018-06-06 13:25:23,http://www.stumbleupon.com/,2853,94,625,1915,1067,2,6556
2018-06-06 13:25:30,https://issuu.com/,1633,1105,1323,2449,12951,12,19473
2018-06-06 13:25:38,https://www.stumbleupon.com/,1286,104,429,4376,1161,112,7468
2018-06-06 13:26:05,https://creativecommons.org/,2880,26,722,6730,14868,23,25249
2018-06-06 13:26:32,https://www.google.co.uk/,12870,95,8323,1148,8383,51,30870
2018-06-06 13:26:43,https://www.addtoany.com/,6168,104,11014,311,13632,0,31229
2018-06-06 13:26:44,https://www.dropbox.com/,13001,290,11034,265,14784,43,39417
2018-06-06 13:26:45,https://www.msn.com/,8292,202,15549,7408,1634,154,33239
2018-06-06 13:26:46,https://aws.amazon.com/,7784,1,8362,9768,16854,4,42773
2018-06-06 13:26:51,https://www.opera.com/,12851,536,9196,833,445,5045,28906
2018-06-06 13:27:00,https://www.parallels.com/,14863,288,3388,787,32964,18,52308
2018-06-06 13:27:06,https://www.e-recht24.de/,10521,935,12933,4751,4280,505,33925
2018-06-06 13:27:27,https://www.etsy.com/,4455,501,2295,16003,4085,1,27340
2018-06-06 13:28:07,https://archive.org/,15857,292,35834,1556,1158,25,54722
2018-06-06 13:28:08,https://www.forbes.com/,7885,135,6126,2335,104851,312,121644
2018-06-06 13:28:10,https://www.washingtonpost.com/,14719,774,2444,14246,54546,3008,89737
2018-06-06 13:28:36,https://cpanel.com/,33547,60,22313,3003,4811,10,63744
2018-06-06 13:28:37,http://www.free.fr/,16414,286,6683,7204,1071,1,31659
2018-06-06 13:28:37,https://ameblo.jp/,14370,208,20531,8957,2308,0,46374
2018-06-06 13:28:43,https://www.ebay.com/,19142,223,16581,5124,1585,67,42722
2018-06-06 13:28:43,https://cpanel.com/,12081,113,19489,2033,2221,33,35970
2018-06-06 13:28:45,https://www.xing.com/,20570,484,18223,7158,29548,7,75990
2018-06-06 13:29:04,https://fc2.com/,17659,148,5720,2095,33359,113,59094
2018-06-06 13:29:21,http://www.typepad.com/,6953,146,30,722,751,29,8631
