"2018-06-23 22:20:23";"https://www.facebook.com/";"2572";"157";"534";"827";"2462";"60";"6612"
"2018-06-23 22:20:30";"https://twitter.com/";"258";"111";"60";"1060";"944";"1";"2434"
"2018-06-23 22:20:31";"https://www.google.com/";"455";"86";"151";"661";"940";"36";"2329"
"2018-06-23 22:20:41";"https://www.youtube.com/";"253";"71";"1540";"865";"2755";"2";"5486"
"2018-06-23 22:20:50";"https://www.linkedin.com/";"379";"403";"35";"1824";"493";"198";"3332"
"2018-06-23 22:21:02";"https://wordpress.org/";"5570";"25";"159";"489";"2829";"0";"9072"
"2018-06-23 22:21:04";"https://www.instagram.com/";"3992";"190";"382";"4068";"748";"16";"9396"
"2018-06-23 22:21:08";"https://www.pinterest.com/";"991";"169";"242";"2846";"6242";"110";"10600"
"2018-06-23 22:21:15";"https://www.wikipedia.org/";"803";"35";"153";"2037";"411";"0";"3439"
"2018-06-23 22:21:17";"https://www.blogger.com/";"1595";"33";"126";"1465";"440";"1";"3660"
"2018-06-23 22:21:20";"https://wordpress.com/";"829";"47";"844";"450";"4947";"122";"7239"
"2018-06-23 22:21:30";"https://www.adobe.com/";"724";"74";"142";"4241";"2694";"340";"8215"
"2018-06-23 22:21:54";"https://www.apple.com/";"447";"36";"683";"7613";"222";"26";"9027"
"2018-06-23 22:21:56";"https://www.tumblr.com/";"745";"134";"217";"8751";"1633";"23";"11503"
"2018-06-23 22:22:08";"https://www.youtube.com/";"1128";"109";"788";"4620";"8410";"34";"15089"
"2018-06-23 22:22:19";"https://www.amazon.com/";"1004";"128";"336";"4549";"6592";"190";"12799"
"2018-06-23 22:22:22";"https://goo.gl/";"1279";"62";"536";"3271";"1079";"0";"6227"
"2018-06-23 22:22:33";"https://www.microsoft.com/";"2001";"462";"151";"1960";"1364";"26";"5964"
"2018-06-23 22:22:35";"https://vimeo.com/";"916";"106";"325";"2808";"7124";"22";"11301"
"2018-06-23 22:23:09";"https://www.flickr.com/";"883";"107";"180";"489";"20256";"23";"21938"
"2018-06-23 22:23:35";"https://www.godaddy.com/";"4758";"279";"5472";"636";"1196";"51";"12392"
"2018-06-23 22:23:40";"http://www.qq.com/";"2055";"24";"273";"10272";"15533";"1";"28158"
"2018-06-23 22:23:45";"https://www.yahoo.com/";"5485";"69";"1097";"6155";"31593";"254";"44653"
"2018-06-23 22:23:50";"https://vk.com/";"4730";"275";"4848";"6012";"7953";"517";"24335"
"2018-06-23 22:23:50";"https://www.buydomains.com/";"5123";"403";"1017";"3628";"32316";"123";"42610"
"2018-06-23 22:23:58";"https://www.w3.org/";"8625";"157";"1715";"6249";"590";"0";"17336"
"2018-06-23 22:24:02";"http://t.co/";"556";"77";"4912";"80";"164";"1";"5790"
"2018-06-23 22:24:04";"http://baidu.com/";"39";"0";"4740";"33";"89";"0";"4901"
"2018-06-23 22:24:09";"http://www.baidu.com/";"932";"251";"1353";"2825";"699";"23";"6083"
"2018-06-23 22:24:20";"http://europa.eu/";"57";"53";"3679";"877";"1253";"24";"5943"
"2018-06-23 22:24:24";"https://www.gov.uk/";"3825";"8";"584";"2196";"781";"1";"7395"
"2018-06-23 22:24:31";"https://www.nytimes.com/";"4519";"223";"2191";"14831";"25994";"620";"48378"
"2018-06-23 22:24:51";"http://statcounter.com/";"102";"561";"4222";"3879";"3199";"1";"11964"
"2018-06-23 22:24:56";"https://www.blogger.com/";"5660";"56";"531";"1489";"678";"1";"8415"
"2018-06-23 22:25:01";"https://www.bbc.co.uk/";"7078";"412";"1359";"4276";"3350";"76";"16551"
"2018-06-23 22:25:10";"https://github.com/";"2432";"100";"1499";"3156";"2588";"2";"9777"
"2018-06-23 22:25:10";"https://www.weebly.com/";"8595";"125";"4611";"8817";"13499";"1";"35648"
"2018-06-23 22:25:11";"https://soundcloud.com/";"3532";"228";"1118";"7655";"14665";"1";"27199"
"2018-06-23 22:25:13";"https://www.mozilla.org/";"9450";"29";"1061";"2627";"2112";"30";"15309"
"2018-06-23 22:25:13";"https://www.google.de/";"4153";"99";"1132";"1147";"2440";"63";"9034"
"2018-06-23 22:25:51";"https://yandex.ru/";"2864";"350";"3477";"11275";"5701";"59";"23726"
"2018-06-23 22:25:56";"https://myspace.com/";"1850";"176";"277";"8340";"30003";"418";"41064"
"2018-06-23 22:26:03";"https://www.jimdo.com/";"4259";"229";"1467";"4510";"25355";"5";"35825"
"2018-06-23 22:26:09";"https://www.bluehost.com/";"2234";"409";"4855";"1405";"9688";"4";"18595"
"2018-06-23 22:26:10";"https://wordpress.com/";"5562";"46";"720";"464";"16402";"691";"23885"
"2018-06-23 22:26:33";"https://www.addthis.com/";"2984";"101";"1508";"1617";"24416";"1660";"32286"
"2018-06-23 22:26:40";"https://www.google.co.jp/";"7703";"90";"5418";"1145";"5961";"161";"20478"
"2018-06-23 22:26:40";"http://en.gravatar.com/";"3065";"151";"1691";"5266";"880";"1";"11054"
"2018-06-23 22:26:40";"https://www.nih.gov/";"7109";"101";"1750";"7369";"1556";"4";"17889"
"2018-06-23 22:26:50";"https://www.theguardian.com/";"8463";"27";"690";"7143";"36335";"60";"52718"
"2018-06-23 22:26:54";"https://www.wix.com/";"4256";"80";"5535";"8063";"15191";"2";"33127"
"2018-06-23 22:26:54";"http://ascii.co.uk/";"312";"115";"4325";"1988";"21870";"18";"28628"
"2018-06-23 22:27:00";"https://outlook.live.com/";"2056";"171";"1696";"6461";"1548";"1";"11933"
"2018-06-23 22:27:01";"https://www.paypal.com/";"6084";"819";"1943";"1389";"5022";"75";"15332"
"2018-06-23 22:27:17";"https://www.elegantthemes.com/";"3834";"59";"1382";"1542";"2678";"196";"9691"
"2018-06-23 22:28:06";"https://www.123-reg.co.uk/";"4694";"0";"1270";"1358";"8578";"665";"16565"
"2018-06-23 22:28:07";"https://www.tripadvisor.com/";"2143";"612";"963";"2289";"8937";"71";"15015"
"2018-06-23 22:28:21";"https://issuu.com/";"2629";"78";"1156";"1806";"11078";"3";"16750"
"2018-06-23 22:28:23";"http://www.stumbleupon.com/";"4477";"80";"850";"2415";"6263";"334";"14419"
"2018-06-23 22:28:35";"https://www.stumbleupon.com/";"172";"416";"1891";"1331";"3347";"253";"7410"
"2018-06-23 22:29:16";"https://www.huffingtonpost.com/";"3513";"27";"3231";"3755";"55496";"13";"66035"
"2018-06-23 22:29:37";"https://creativecommons.org/";"3657";"0";"2810";"11266";"40246";"3";"57982"
"2018-06-23 22:29:50";"https://www.google.co.uk/";"20522";"88";"15886";"1162";"7704";"124";"45486"
"2018-06-23 22:30:01";"https://www.msn.com/";"15454";"273";"4924";"7044";"1568";"30";"29293"
"2018-06-23 22:30:19";"https://www.addtoany.com/";"17919";"40";"4168";"1197";"25617";"1";"48942"
"2018-06-23 22:30:19";"https://www.dropbox.com/";"24766";"177";"10076";"1258";"28517";"12";"64806"
"2018-06-23 22:30:19";"https://www.e-recht24.de/";"7544";"888";"22518";"3924";"4009";"779";"39662"
"2018-06-23 22:30:32";"https://aws.amazon.com/";"19932";"1";"10315";"19790";"22517";"35";"72590"
"2018-06-23 22:30:35";"https://www.opera.com/";"8763";"705";"11118";"4537";"26027";"43";"51193"
"2018-06-23 22:31:11";"http://www.free.fr/";"5082";"9";"91";"3999";"1015";"0";"10196"
"2018-06-23 22:31:12";"https://cpanel.com/";"1480";"162";"361";"1339";"4013";"6";"7361"
"2018-06-23 22:31:32";"https://www.livejournal.com/";"1720";"186";"145";"5332";"16869";"24";"24276"
"2018-06-23 22:32:40";"https://www.wikimedia.org/";"5136";"739";"3313";"99";"7151";"1";"16439"
"2018-06-23 22:33:02";"http://www.typepad.com/";"4811";"600";"2896";"7906";"15716";"169";"32098"
"2018-06-23 22:33:07";"https://weibo.com/";"2948";"1029";"1452";"11222";"64935";"5";"81591"
