2018-06-06 12:29:48,https://www.facebook.com/,2313,228,427,999,1400,37,5404
2018-06-06 12:29:57,https://twitter.com/,267,128,211,629,1279,3,2517
2018-06-06 12:29:58,https://www.google.com/,493,110,282,700,963,37,2585
2018-06-06 12:30:08,https://www.youtube.com/,272,67,562,1408,2903,12,5224
2018-06-06 12:30:20,https://www.linkedin.com/,265,2312,113,1623,352,114,4779
2018-06-06 12:30:26,https://wordpress.org/,284,62,341,1117,2122,0,3926
2018-06-06 12:30:30,https://www.instagram.com/,1521,143,298,2491,346,13,4812
2018-06-06 12:30:34,https://www.pinterest.com/,823,183,91,525,5266,150,7038
2018-06-06 12:30:43,https://www.wikipedia.org/,583,36,322,3899,120,12,4972
2018-06-06 12:30:47,https://www.blogger.com/,1140,35,284,1769,414,0,3642
2018-06-06 12:30:49,https://wordpress.com/,881,46,718,523,4396,348,6912
2018-06-06 12:31:05,https://www.adobe.com/,408,49,382,4845,6688,417,12789
2018-06-06 12:31:26,https://www.apple.com/,530,49,647,5554,1394,5,8179
2018-06-06 12:31:28,https://www.tumblr.com/,576,148,393,8001,1267,58,10443
2018-06-06 12:31:33,https://www.youtube.com/,974,67,543,3104,3149,25,7862
2018-06-06 12:31:51,https://goo.gl/,1013,88,469,1521,2084,15,5190
2018-06-06 12:31:55,https://www.amazon.com/,845,111,1192,3649,11533,19,17349
2018-06-06 12:32:08,https://www.microsoft.com/,1526,201,293,3952,1691,29,7692
2018-06-06 12:32:13,https://vimeo.com/,1931,115,520,2639,10079,77,15361
2018-06-06 12:32:33,https://www.flickr.com/,944,2205,198,349,8551,18,12265
2018-06-06 12:32:50,https://www.yahoo.com/,1063,68,1202,4438,10823,239,17833
2018-06-06 12:32:54,https://www.buydomains.com/,2182,359,689,1344,8906,203,13683
2018-06-06 12:32:59,https://www.godaddy.com/,1112,331,738,650,447,33,3311
2018-06-06 12:33:01,http://www.qq.com/,1569,23,229,7249,7776,2,16848
2018-06-06 12:33:08,https://vk.com/,1558,185,495,4730,3442,87,10497
2018-06-06 12:33:19,https://www.w3.org/,4044,55,533,609,1432,1,6674
2018-06-06 12:33:31,http://t.co/,141,80,1629,91,737,1,2679
2018-06-06 12:33:33,https://www.reddit.com/,3131,640,725,940,21652,11,27099
2018-06-06 12:33:38,http://baidu.com/,31,83,1294,59,234,0,1701
2018-06-06 12:33:42,http://www.baidu.com/,1172,431,352,1697,849,41,4542
2018-06-06 12:33:46,https://www.nytimes.com/,1823,26,519,9902,16252,30,28552
2018-06-06 12:33:50,http://europa.eu/,28,0,740,309,1219,2,2298
2018-06-06 12:33:55,https://www.gov.uk/,910,26,231,792,631,6,2596
2018-06-06 12:34:26,http://statcounter.com/,69,709,1440,2549,3615,1,8383
2018-06-06 12:34:30,https://www.weebly.com/,1254,151,204,3937,11193,2,16741
2018-06-06 12:34:30,https://www.blogger.com/,3209,32,597,1397,630,1,5866
2018-06-06 12:34:43,https://soundcloud.com/,3018,167,644,4160,12136,2,20127
2018-06-06 12:34:45,http://www.bbc.com/,927,24,1082,8373,6222,66,16694
2018-06-06 12:34:51,https://www.mozilla.org/,3781,49,733,1468,3274,2,9307
2018-06-06 12:34:53,https://github.com/,1154,180,1020,6203,2347,2,10906
2018-06-06 12:34:58,https://www.google.de/,3888,117,1605,757,2147,111,8625
2018-06-06 12:35:10,https://myspace.com/,1210,820,816,6763,5173,105,14887
2018-06-06 12:35:18,https://www.jimdo.com/,1251,34,561,1456,4264,41,7607
2018-06-06 12:35:19,https://yandex.ru/,5472,332,521,5020,726,3,12074
2018-06-06 12:35:33,https://wordpress.com/,1070,46,1720,697,3221,344,7098
2018-06-06 12:35:37,https://www.bluehost.com/,1821,1217,372,2723,1156,14,7303
2018-06-06 12:35:54,https://www.addthis.com/,1871,170,780,1335,4596,296,9048
2018-06-06 12:36:08,https://www.theguardian.com/,1823,29,161,4654,20290,4,26961
2018-06-06 12:36:17,https://www.google.co.jp/,2968,166,3792,1126,3260,103,11415
2018-06-06 12:36:18,https://www.nih.gov/,2037,60,1648,2566,1454,43,7808
2018-06-06 12:36:20,https://www.wix.com/,2017,89,2076,1749,7470,2,13403
2018-06-06 12:36:21,http://en.gravatar.com/,1601,60,607,1738,425,1,4432
2018-06-06 12:36:24,http://ascii.co.uk/,554,101,2849,1887,4721,101,10213
2018-06-06 12:36:37,https://www.paypal.com/,2359,394,780,1190,97,84,4904
2018-06-06 12:36:54,https://outlook.live.com/,2623,70,697,4007,12799,0,20196
2018-06-06 12:37:04,https://www.elegantthemes.com/,2100,75,738,902,2698,7,6520
2018-06-06 12:37:04,https://www.cnn.com/,3155,44,524,4985,27716,203,36627
2018-06-06 12:37:42,https://www.123-reg.co.uk/,1210,1,574,638,3941,458,6822
2018-06-06 12:37:47,https://www.tripadvisor.com/,2340,972,244,476,3513,25,7570
2018-06-06 12:38:12,https://issuu.com/,2460,74,664,4086,7627,12,14923
2018-06-06 12:38:17,http://www.stumbleupon.com/,3794,80,599,1132,3821,356,9782
2018-06-06 12:38:23,https://www.stumbleupon.com/,11,92,623,1261,2667,350,5004
2018-06-06 12:38:25,https://www.huffingtonpost.com/,1827,24,874,2931,24129,36,29821
2018-06-06 12:38:45,http://digg.com/,126,220,1804,5726,6035,153,14064
2018-06-06 12:38:55,https://creativecommons.org/,2423,0,1048,4833,13893,2,22199
2018-06-06 12:39:05,https://www.google.co.uk/,7175,190,1082,1019,5353,64,14883
2018-06-06 12:39:13,https://www.dropbox.com/,5363,257,2051,371,8348,53,16443
2018-06-06 12:39:16,https://aws.amazon.com/,2877,35,1448,12087,2586,5,19038
2018-06-06 12:39:19,https://www.imdb.com/,6589,496,7293,6537,13975,33,34923
2018-06-06 12:39:21,https://www.parallels.com/,9663,1074,1428,3814,19104,4,35087
2018-06-06 12:39:36,https://www.msn.com/,6436,163,4627,4930,3540,14,19710
2018-06-06 12:39:36,https://www.yelp.com/,5444,545,736,7946,32311,2,46984
2018-06-06 12:39:37,https://www.addtoany.com/,8798,33,4825,689,9393,2,23740
2018-06-06 12:39:49,https://www.opera.com/,9270,309,2678,370,10208,15,22850
2018-06-06 12:39:50,https://www.e-recht24.de/,4474,385,2188,8298,2157,72,17574
2018-06-06 12:39:54,https://www.forbes.com/,12313,137,3231,2373,29106,63,47223
2018-06-06 12:40:13,https://www.etsy.com/,4078,285,1744,7559,2656,1,16323
2018-06-06 12:40:26,https://archive.org/,4415,219,576,2016,414,28,7668
2018-06-06 12:40:29,https://www.eventbrite.com/,6711,428,546,3361,3504,36,14586
2018-06-06 12:40:33,https://cpanel.com/,3469,59,1984,404,999,4,6919
2018-06-06 12:40:41,https://www.xing.com/,2617,390,689,1356,3486,8,8546
2018-06-06 12:41:12,https://www.ebay.com/,3923,179,1682,8092,783,96,14755
2018-06-06 12:41:16,https://ameblo.jp/,6154,366,3253,8667,5354,1,23795
2018-06-06 12:41:26,http://www.free.fr/,10068,171,6560,1805,246,1,18851
2018-06-06 12:41:27,https://fc2.com/,2260,101,1719,2782,22264,79,29205
2018-06-06 12:41:27,https://www.amazon.co.uk/,6832,265,2914,2609,22645,55,35320
2018-06-06 12:41:33,https://www.bing.com/,14561,144,1637,2661,33,49,19085
2018-06-06 12:41:36,https://sourceforge.net/,12085,413,2469,7962,33804,176,56909
2018-06-06 12:41:45,https://cpanel.com/,9848,6,1882,1766,14468,45,28015
2018-06-06 12:42:16,https://www.livejournal.com/,6687,262,2135,13031,30350,85,52550
2018-06-06 12:42:20,https://www.reuters.com/,7941,413,3145,14536,32006,270,58311
2018-06-06 12:42:54,https://www.wikimedia.org/,8107,94,3399,107,8615,1,20323
2018-06-06 12:42:55,https://www.bloomberg.com/,3357,48,1810,1787,44424,77,51503
2018-06-06 12:43:00,http://www.typepad.com/,11310,178,1450,1692,3645,131,18406
2018-06-06 12:43:05,https://weibo.com/,10936,1106,1927,8156,44668,2,66795
2018-06-06 12:43:30,https://www.aol.com/,3090,8427,3167,5991,30567,849,52091
