"2018-06-24 16:07:04";"https://twitter.com/";"547";"288";"192";"1587";"1606";"12";"4232"
"2018-06-24 16:07:04";"https://www.google.com/";"329";"140";"252";"851";"2017";"86";"3675"
"2018-06-24 16:07:06";"https://www.facebook.com/";"11745";"164";"2513";"2278";"2627";"45";"19372"
"2018-06-24 16:07:11";"https://www.youtube.com/";"298";"150";"749";"1371";"177";"8";"2753"
"2018-06-24 16:07:22";"https://www.linkedin.com/";"250";"313";"52";"1255";"259";"135";"2264"
"2018-06-24 16:07:36";"https://www.instagram.com/";"5238";"144";"25";"1363";"1053";"35";"7858"
"2018-06-24 16:07:40";"https://wordpress.org/";"584";"15";"39";"1339";"1773";"0";"3750"
"2018-06-24 16:07:45";"https://www.pinterest.com/";"5422";"176";"84";"827";"7753";"219";"14481"
"2018-06-24 16:07:50";"https://www.wikipedia.org/";"1063";"39";"236";"3393";"224";"0";"4955"
"2018-06-24 16:07:52";"https://www.blogger.com/";"1568";"24";"128";"1221";"414";"0";"3355"
"2018-06-24 16:07:54";"https://wordpress.com/";"808";"46";"580";"2724";"2144";"120";"6422"
"2018-06-24 16:08:07";"https://www.adobe.com/";"459";"1";"118";"4106";"3982";"535";"9201"
"2018-06-24 16:08:31";"https://www.apple.com/";"520";"33";"674";"7572";"447";"76";"9322"
"2018-06-24 16:08:32";"https://www.tumblr.com/";"730";"182";"199";"8195";"1625";"186";"11117"
"2018-06-24 16:08:35";"https://www.youtube.com/";"1321";"134";"746";"2581";"324";"59";"5165"
"2018-06-24 16:08:54";"https://goo.gl/";"510";"54";"165";"1155";"1332";"1";"3217"
"2018-06-24 16:08:55";"https://www.amazon.com/";"654";"124";"334";"2276";"9106";"23";"12517"
"2018-06-24 16:09:09";"https://vimeo.com/";"505";"100";"108";"2624";"5496";"50";"8883"
"2018-06-24 16:09:10";"https://www.microsoft.com/";"1326";"148";"307";"2062";"1782";"18";"5643"
"2018-06-24 16:09:34";"https://www.flickr.com/";"830";"104";"83";"374";"8267";"10";"9668"
"2018-06-24 16:09:57";"https://www.yahoo.com/";"1044";"59";"818";"3198";"13007";"85";"18211"
"2018-06-24 16:10:08";"https://www.godaddy.com/";"2834";"254";"2350";"378";"1007";"4";"6827"
"2018-06-24 16:10:13";"https://www.buydomains.com/";"4352";"1348";"718";"1440";"15726";"23";"23607"
"2018-06-24 16:10:18";"http://www.qq.com/";"2060";"940";"615";"8002";"14787";"2";"26406"
"2018-06-24 16:10:18";"https://vk.com/";"2708";"168";"785";"4627";"3973";"204";"12465"
"2018-06-24 16:10:27";"https://www.w3.org/";"2898";"42";"899";"3456";"391";"0";"7686"
"2018-06-24 16:10:31";"https://www.reddit.com/";"3020";"672";"1586";"486";"16216";"13";"21993"
"2018-06-24 16:10:35";"http://t.co/";"109";"74";"1335";"35";"151";"0";"1704"
"2018-06-24 16:10:43";"http://baidu.com/";"47";"32";"1000";"3";"118";"1";"1201"
"2018-06-24 16:10:47";"http://www.baidu.com/";"933";"450";"745";"2042";"698";"4";"4872"
"2018-06-24 16:10:48";"https://www.nytimes.com/";"2954";"16";"637";"10771";"9129";"27";"23534"
"2018-06-24 16:10:58";"http://europa.eu/";"42";"0";"980";"423";"1850";"5";"3300"
"2018-06-24 16:11:03";"https://www.gov.uk/";"1096";"14";"428";"1244";"922";"5";"3709"
"2018-06-24 16:11:34";"http://statcounter.com/";"112";"777";"2326";"5117";"2574";"1";"10907"
"2018-06-24 16:11:35";"https://www.weebly.com/";"1544";"300";"70";"3789";"10737";"2";"16442"
"2018-06-24 16:11:37";"https://www.blogger.com/";"3840";"156";"408";"1169";"769";"1";"6343"
"2018-06-24 16:11:42";"https://www.bbc.co.uk/";"5643";"257";"472";"4113";"3252";"130";"13867"
"2018-06-24 16:11:49";"https://soundcloud.com/";"2935";"361";"613";"4279";"12196";"2";"20386"
"2018-06-24 16:11:54";"https://github.com/";"1261";"94";"208";"4568";"1159";"2";"7292"
"2018-06-24 16:11:54";"https://www.mozilla.org/";"6303";"18";"71";"2072";"732";"6";"9202"
"2018-06-24 16:12:11";"https://www.google.de/";"1617";"13636";"90";"659";"1426";"13";"17441"
"2018-06-24 16:12:14";"https://myspace.com/";"3805";"141";"96";"7965";"3528";"96";"15631"
"2018-06-24 16:12:36";"https://yandex.ru/";"5395";"330";"668";"7900";"4214";"87";"18594"
"2018-06-24 16:12:44";"https://www.jimdo.com/";"3456";"217";"470";"2022";"20110";"7";"26282"
"2018-06-24 16:12:59";"https://www.bluehost.com/";"3407";"425";"698";"5654";"11120";"3";"21307"
"2018-06-24 16:13:01";"https://wordpress.com/";"6630";"45";"1307";"3364";"16323";"536";"28205"
"2018-06-24 16:13:08";"https://www.addthis.com/";"2626";"107";"1001";"1373";"8853";"221";"14181"
"2018-06-24 16:13:28";"https://www.google.co.jp/";"6110";"83";"7648";"1102";"4069";"169";"19181"
"2018-06-24 16:13:32";"http://en.gravatar.com/";"2312";"128";"1243";"4066";"706";"0";"8455"
"2018-06-24 16:13:35";"https://www.nih.gov/";"7378";"18";"1950";"6228";"2452";"79";"18105"
"2018-06-24 16:13:43";"https://www.theguardian.com/";"9903";"230";"1842";"3388";"34754";"11";"50128"
"2018-06-24 16:13:44";"https://www.wix.com/";"2727";"53";"7246";"2407";"18330";"3";"30766"
"2018-06-24 16:13:45";"http://ascii.co.uk/";"120";"103";"3484";"1875";"19390";"17";"24989"
"2018-06-24 16:13:52";"https://www.paypal.com/";"7739";"456";"756";"1557";"848";"130";"11486"
"2018-06-24 16:14:12";"https://www.elegantthemes.com/";"2878";"47";"532";"1850";"1359";"91";"6757"
"2018-06-24 16:14:45";"https://www.cnn.com/";"11688";"273";"1048";"11276";"39906";"306";"64497"
"2018-06-24 16:15:02";"https://www.123-reg.co.uk/";"3516";"0";"3254";"687";"8419";"1254";"17130"
"2018-06-24 16:15:03";"https://www.tripadvisor.com/";"2845";"368";"931";"2054";"10004";"49";"16251"
"2018-06-24 16:15:15";"http://www.stumbleupon.com/";"1575";"71";"1063";"1292";"1046";"2";"5049"
"2018-06-24 16:15:38";"https://www.stumbleupon.com/";"577";"104";"540";"1769";"9157";"758";"12905"
"2018-06-24 16:15:38";"https://issuu.com/";"3318";"4583";"798";"1622";"18503";"6";"28830"
"2018-06-24 16:16:37";"https://www.google.co.uk/";"13178";"179";"6176";"2080";"9337";"51";"31001"
"2018-06-24 16:16:43";"https://www.parallels.com/";"15340";"437";"4653";"2326";"16696";"4";"39456"
"2018-06-24 16:16:43";"https://creativecommons.org/";"4506";"4";"7124";"17952";"21733";"3";"51322"
"2018-06-24 16:16:44";"https://aws.amazon.com/";"6042";"0";"5843";"12678";"11605";"26";"36194"
"2018-06-24 16:16:48";"https://www.dropbox.com/";"12771";"195";"18164";"973";"14500";"29";"46632"
"2018-06-24 16:16:59";"https://www.msn.com/";"22195";"368";"4101";"4931";"533";"30";"32158"
"2018-06-24 16:17:14";"https://www.addtoany.com/";"23992";"132";"4721";"457";"17578";"1";"46881"
"2018-06-24 16:17:15";"https://www.e-recht24.de/";"6740";"494";"15023";"3682";"3297";"666";"29902"
"2018-06-24 16:17:16";"https://www.opera.com/";"10182";"1";"9446";"1359";"14960";"2";"35950"
"2018-06-24 16:17:46";"http://go.com/";"158";"43";"10609";"7636";"39303";"151";"57900"
"2018-06-24 16:18:08";"https://www.etsy.com/";"9494";"323";"9202";"12525";"16406";"0";"47950"
"2018-06-24 16:18:17";"https://archive.org/";"8486";"651";"22835";"8582";"1385";"90";"42029"
"2018-06-24 16:18:40";"https://cpanel.com/";"27435";"1089";"26986";"623";"880";"6";"57019"
"2018-06-24 16:18:47";"http://www.free.fr/";"14643";"257";"11644";"3680";"2376";"1";"32601"
"2018-06-24 16:18:49";"https://www.xing.com/";"11667";"2565";"29744";"9544";"6424";"1";"59945"
"2018-06-24 16:18:50";"https://www.eventbrite.com/";"22898";"606";"25613";"17572";"17701";"418";"84808"
"2018-06-24 16:18:54";"https://www.bing.com/";"22633";"303";"4219";"2312";"910";"1";"30378"
"2018-06-24 16:18:55";"https://cpanel.com/";"11908";"0";"3016";"294";"8198";"2";"23418"
"2018-06-24 16:18:56";"https://fc2.com/";"15665";"73";"15831";"3633";"8964";"45";"44211"
"2018-06-24 16:19:13";"https://ameblo.jp/";"14850";"284";"22666";"10146";"8615";"1";"56562"
"2018-06-24 16:19:20";"https://www.ebay.com/";"11392";"100";"22513";"6592";"22148";"74";"62819"
"2018-06-24 16:19:29";"https://www.amazon.co.uk/";"28135";"187";"9695";"7743";"36668";"64";"82492"
"2018-06-24 16:20:17";"http://www.typepad.com/";"4001";"204";"67";"813";"695";"1";"5781"
