"2018-06-24 16:54:31";"https://www.facebook.com/";"2549";"195";"127";"1404";"2656";"87";"7018"
"2018-06-24 16:54:36";"https://twitter.com/";"316";"134";"253";"885";"1002";"4";"2594"
"2018-06-24 16:54:37";"https://www.google.com/";"446";"97";"127";"779";"1100";"47";"2596"
"2018-06-24 16:54:43";"https://www.youtube.com/";"327";"82";"1629";"520";"241";"2";"2801"
"2018-06-24 16:54:52";"https://www.linkedin.com/";"257";"804";"47";"280";"1300";"145";"2833"
"2018-06-24 16:54:57";"https://wordpress.org/";"276";"15";"87";"1138";"1751";"0";"3267"
"2018-06-24 16:55:03";"https://www.instagram.com/";"998";"73";"174";"2279";"1063";"7";"4594"
"2018-06-24 16:55:08";"https://www.pinterest.com/";"835";"730";"41";"626";"6283";"277";"8792"
"2018-06-24 16:55:16";"https://www.blogger.com/";"1364";"22";"100";"1600";"364";"1";"3451"
"2018-06-24 16:55:18";"https://www.wikipedia.org/";"1431";"37";"742";"555";"4016";"0";"6781"
"2018-06-24 16:55:21";"https://wordpress.com/";"991";"40";"162";"3589";"3255";"314";"8351"
"2018-06-24 16:55:30";"https://www.adobe.com/";"474";"1";"102";"4065";"3705";"463";"8810"
"2018-06-24 16:55:48";"https://www.apple.com/";"756";"99";"198";"6539";"646";"41";"8279"
"2018-06-24 16:55:51";"https://www.tumblr.com/";"829";"136";"337";"9257";"1022";"33";"11614"
"2018-06-24 16:55:54";"https://www.youtube.com/";"1306";"64";"751";"6019";"267";"2";"8409"
"2018-06-24 16:56:08";"https://www.amazon.com/";"932";"95";"306";"3844";"5842";"26";"11045"
"2018-06-24 16:56:09";"https://goo.gl/";"1171";"94";"218";"2693";"777";"13";"4966"
"2018-06-24 16:56:18";"https://www.microsoft.com/";"1646";"205";"222";"2386";"1077";"27";"5563"
"2018-06-24 16:56:21";"https://vimeo.com/";"901";"99";"122";"1877";"7633";"25";"10657"
"2018-06-24 16:56:43";"https://www.flickr.com/";"1141";"58";"150";"449";"11732";"18";"13548"
"2018-06-24 16:57:11";"https://www.godaddy.com/";"3702";"436";"4651";"1226";"1143";"51";"11209"
"2018-06-24 16:57:27";"https://www.yahoo.com/";"1221";"77";"872";"6224";"35702";"284";"44380"
"2018-06-24 16:57:27";"https://www.w3.org/";"7678";"174";"2529";"1270";"2910";"0";"14561"
"2018-06-24 16:57:30";"https://vk.com/";"3729";"203";"4323";"7660";"9875";"44";"25834"
"2018-06-24 16:57:34";"https://www.buydomains.com/";"5955";"323";"923";"3067";"31368";"16";"41652"
"2018-06-24 16:57:34";"http://t.co/";"5315";"39";"1262";"2";"263";"1";"6882"
"2018-06-24 16:57:36";"http://baidu.com/";"258";"231";"3985";"5";"127";"0";"4606"
"2018-06-24 16:57:36";"http://www.qq.com/";"2244";"5";"1256";"9731";"31295";"3";"44534"
"2018-06-24 16:57:44";"http://www.baidu.com/";"1854";"353";"2076";"3786";"324";"9";"8402"
"2018-06-24 16:57:47";"http://europa.eu/";"57";"175";"1712";"432";"1854";"3";"4233"
"2018-06-24 16:57:50";"https://www.nytimes.com/";"3760";"200";"2701";"13065";"13573";"123";"33422"
"2018-06-24 16:57:50";"https://www.reddit.com/";"7871";"1090";"4695";"960";"29138";"111";"43865"
"2018-06-24 16:57:51";"https://www.gov.uk/";"2748";"133";"495";"1896";"872";"1";"6145"
"2018-06-24 16:58:13";"https://www.weebly.com/";"2633";"415";"3861";"2314";"2990";"9";"12222"
"2018-06-24 16:58:13";"http://statcounter.com/";"77";"552";"3022";"3870";"3484";"0";"11005"
"2018-06-24 16:58:18";"https://www.blogger.com/";"5532";"24";"771";"1710";"686";"0";"8723"
"2018-06-24 16:58:38";"https://github.com/";"3193";"109";"2096";"5002";"3502";"2";"13904"
"2018-06-24 16:58:43";"https://www.google.de/";"5657";"83";"4138";"1453";"5216";"20";"16567"
"2018-06-24 16:58:48";"https://www.mozilla.org/";"10991";"15";"4379";"3279";"6746";"2";"25412"
"2018-06-24 16:58:50";"https://soundcloud.com/";"3471";"332";"952";"8057";"29415";"1";"42228"
"2018-06-24 16:59:06";"http://www.bbc.com/";"4093";"13";"5485";"8439";"24305";"2601";"44936"
"2018-06-24 16:59:35";"https://www.jimdo.com/";"2509";"114";"791";"8664";"26426";"5";"38509"
"2018-06-24 16:59:59";"http://en.gravatar.com/";"5746";"79";"5485";"2280";"1601";"0";"15191"
"2018-06-24 17:00:00";"https://www.bluehost.com/";"8605";"1035";"6803";"10525";"23896";"2";"50866"
"2018-06-24 17:00:02";"https://www.google.co.jp/";"13496";"89";"8333";"1363";"6110";"37";"29428"
"2018-06-24 17:00:03";"https://www.addthis.com/";"3208";"158";"5555";"3569";"29950";"1477";"43917"
"2018-06-24 17:00:04";"https://wordpress.com/";"15044";"187";"7411";"1473";"39619";"78";"63812"
"2018-06-24 17:00:05";"https://www.paypal.com/";"8576";"529";"1411";"3073";"534";"797";"14920"
"2018-06-24 17:00:06";"http://ascii.co.uk/";"134";"100";"5561";"5999";"12751";"264";"24809"
"2018-06-24 17:00:09";"https://www.nih.gov/";"13637";"45";"4259";"9064";"1750";"5";"28760"
"2018-06-24 17:00:14";"https://www.wix.com/";"9766";"48";"8626";"3109";"12788";"2";"34339"
"2018-06-24 17:00:18";"https://outlook.live.com/";"3417";"263";"2514";"9081";"9455";"1";"24731"
"2018-06-24 17:00:25";"https://www.elegantthemes.com/";"5655";"70";"2145";"2903";"2766";"46";"13585"
"2018-06-24 17:00:32";"https://www.theguardian.com/";"30531";"22";"6284";"4366";"34806";"177";"76186"
"2018-06-24 17:01:00";"https://www.tripadvisor.com/";"2318";"255";"580";"1832";"7707";"56";"12748"
"2018-06-24 17:01:03";"https://www.123-reg.co.uk/";"2686";"1";"2868";"5240";"6628";"431";"17854"
"2018-06-24 17:01:16";"http://www.stumbleupon.com/";"2286";"68";"410";"1345";"5012";"825";"9946"
"2018-06-24 17:01:26";"https://issuu.com/";"4202";"65";"2957";"1265";"12561";"73";"21123"
"2018-06-24 17:01:32";"https://www.stumbleupon.com/";"1989";"74";"263";"2492";"3351";"329";"8498"
"2018-06-24 17:02:47";"https://www.google.co.uk/";"26999";"81";"17610";"1033";"15811";"10";"61544"
"2018-06-24 17:03:28";"https://www.bing.com/";"1406";"113";"228";"761";"666";"2";"3176"
"2018-06-24 17:03:34";"http://www.free.fr/";"1273";"112";"385";"5480";"1313";"1";"8564"
"2018-06-24 17:03:45";"https://cpanel.com/";"863";"50";"470";"3369";"8454";"4";"13210"
"2018-06-24 17:03:46";"https://fc2.com/";"4858";"115";"399";"4394";"14507";"2";"24275"
"2018-06-24 17:04:27";"https://www.livejournal.com/";"9374";"272";"579";"5108";"35300";"312";"50945"
"2018-06-24 17:04:46";"https://weibo.com/";"2007";"992";"963";"4247";"34392";"139";"42740"
"2018-06-24 17:04:53";"https://www.wikimedia.org/";"4887";"231";"2842";"55";"9888";"1";"17904"
"2018-06-24 17:04:59";"http://www.typepad.com/";"4057";"278";"2062";"3906";"8239";"0";"18542"
"2018-06-24 17:05:09";"https://www.reuters.com/";"6473";"2875";"289";"8507";"71320";"1332";"90796"
"2018-06-24 17:05:36";"https://www.bloomberg.com/";"1980";"126";"2848";"5028";"77137";"666";"87785"
