"2018-05-28 11:55:19";"https://www.facebook.com/";"2280";"180";"324";"1122";"1347";"25";"5278"
"2018-05-28 11:55:28";"https://twitter.com/";"326";"113";"168";"555";"1124";"1";"2287"
"2018-05-28 11:55:29";"https://www.google.com/";"621";"101";"233";"594";"1573";"33";"3155"
"2018-05-28 11:55:37";"https://www.youtube.com/";"335";"63";"1705";"726";"704";"2";"3535"
"2018-05-28 11:55:49";"https://www.linkedin.com/";"239";"1937";"97";"338";"1414";"62";"4087"
"2018-05-28 11:55:54";"https://wordpress.org/";"312";"45";"341";"877";"1463";"0";"3038"
"2018-05-28 11:55:58";"https://www.instagram.com/";"1735";"113";"223";"1194";"607";"8";"3880"
"2018-05-28 11:56:02";"https://www.pinterest.com/";"898";"603";"60";"605";"3940";"110";"6216"
"2018-05-28 11:56:13";"https://www.blogger.com/";"1416";"35";"208";"1359";"378";"0";"3396"
"2018-05-28 11:56:13";"https://www.wikipedia.org/";"902";"35";"1021";"827";"2938";"1";"5724"
"2018-05-28 11:56:15";"https://wordpress.com/";"730";"62";"985";"3131";"1677";"107";"6692"
"2018-05-28 11:56:24";"https://www.adobe.com/";"452";"1";"436";"2613";"2229";"157";"5888"
"2018-05-28 11:56:51";"https://www.tumblr.com/";"971";"117";"334";"5727";"808";"22";"7979"
"2018-05-28 11:56:55";"https://www.apple.com/";"2924";"104";"1023";"6589";"762";"35";"11437"
"2018-05-28 11:56:57";"https://www.youtube.com/";"1266";"72";"606";"4159";"991";"16";"7110"
"2018-05-28 11:57:15";"https://goo.gl/";"5077";"89";"119";"961";"744";"1";"6991"
"2018-05-28 11:57:31";"https://www.microsoft.com/";"2364";"180";"472";"3541";"554";"27";"7138"
"2018-05-28 11:57:34";"https://www.amazon.com/";"584";"16253";"309";"4526";"9640";"32";"31344"
"2018-05-28 11:57:36";"https://vimeo.com/";"1034";"105";"1256";"3008";"10811";"25";"16239"
"2018-05-28 11:57:54";"https://www.flickr.com/";"1533";"186";"429";"441";"7471";"11";"10071"
"2018-05-28 11:58:20";"https://www.yahoo.com/";"1504";"60";"1321";"3743";"16659";"133";"23420"
"2018-05-28 11:58:26";"https://www.godaddy.com/";"3341";"179";"3119";"537";"799";"34";"8009"
"2018-05-28 11:58:27";"https://www.buydomains.com/";"2724";"244";"2541";"2512";"16505";"219";"24745"
"2018-05-28 11:58:32";"http://www.qq.com/";"1730";"34";"387";"9507";"14676";"2";"26336"
"2018-05-28 11:58:40";"https://vk.com/";"2195";"192";"3141";"5959";"5238";"209";"16934"
"2018-05-28 11:58:46";"https://www.w3.org/";"3204";"60";"3611";"930";"2689";"1";"10495"
"2018-05-28 11:58:50";"http://t.co/";"133";"60";"2632";"182";"200";"0";"3207"
"2018-05-28 11:58:58";"http://baidu.com/";"59";"197";"2833";"28";"107";"0";"3224"
"2018-05-28 11:58:59";"https://www.reddit.com/";"2920";"583";"6683";"1878";"23560";"45";"35669"
"2018-05-28 11:59:08";"https://www.baidu.com/";"1010";"251";"422";"8665";"600";"7";"10955"
"2018-05-28 11:59:14";"http://europa.eu/";"72";"11";"2318";"1943";"3103";"2";"7449"
"2018-05-28 11:59:16";"https://www.nytimes.com/";"3272";"246";"3361";"17668";"12902";"73";"37522"
"2018-05-28 11:59:17";"https://www.gov.uk/";"2413";"26";"510";"937";"1360";"2";"5248"
"2018-05-28 11:59:45";"https://www.weebly.com/";"1671";"172";"343";"3664";"9590";"3";"15443"
"2018-05-28 11:59:46";"http://statcounter.com/";"105";"1358";"3326";"4954";"2025";"1";"11769"
"2018-05-28 11:59:48";"https://www.blogger.com/";"4520";"76";"636";"1348";"590";"0";"7170"
"2018-05-28 12:00:11";"https://github.com/";"3710";"96";"4812";"2704";"1665";"2";"12989"
"2018-05-28 12:00:11";"https://soundcloud.com/";"4236";"157";"822";"3652";"22696";"1";"31564"
"2018-05-28 12:00:15";"https://www.google.de/";"4617";"197";"3882";"948";"4419";"46";"14109"
"2018-05-28 12:00:16";"http://www.bbc.com/";"594";"67";"345";"7447";"18025";"1068";"27546"
"2018-05-28 12:00:16";"https://www.mozilla.org/";"931";"235";"641";"1236";"3419";"3";"6465"
"2018-05-28 12:00:34";"https://yandex.ru/";"2331";"294";"2978";"6382";"1137";"21";"13143"
"2018-05-28 12:00:38";"https://www.jimdo.com/";"2637";"175";"991";"1673";"8706";"1";"14183"
"2018-05-28 12:00:59";"https://www.bluehost.com/";"4177";"387";"1248";"1669";"7953";"42";"15476"
"2018-05-28 12:01:01";"https://wordpress.com/";"6956";"54";"678";"745";"12748";"412";"21593"
"2018-05-28 12:01:22";"https://www.addthis.com/";"2258";"33";"1019";"1854";"14461";"142";"19767"
"2018-05-28 12:01:37";"https://www.google.co.jp/";"6252";"100";"9284";"990";"4846";"106";"21578"
"2018-05-28 12:01:37";"http://en.gravatar.com/";"2950";"84";"1237";"3994";"583";"0";"8848"
"2018-05-28 12:01:37";"https://www.nih.gov/";"8714";"46";"1129";"4501";"2689";"47";"17126"
"2018-05-28 12:01:46";"https://www.wix.com/";"7790";"181";"5038";"2967";"14860";"5";"30841"
"2018-05-28 12:01:47";"http://ascii.co.uk/";"197";"107";"4437";"2299";"16251";"41";"23332"
"2018-05-28 12:01:51";"https://www.paypal.com/";"5492";"271";"1602";"652";"2641";"28";"10686"
"2018-05-28 12:01:52";"https://outlook.live.com/";"2413";"110";"1442";"4215";"1078";"0";"9258"
"2018-05-28 12:02:11";"https://www.elegantthemes.com/";"4069";"56";"808";"1301";"1339";"8";"7581"
"2018-05-28 12:02:24";"https://www.cnn.com/";"7746";"45";"1017";"8296";"28994";"333";"46431"
"2018-05-28 12:02:50";"https://www.123-reg.co.uk/";"2471";"19";"1354";"707";"7007";"1281";"12839"
"2018-05-28 12:02:52";"https://www.tripadvisor.com/";"2599";"1199";"396";"624";"4534";"28";"9380"
"2018-05-28 12:03:15";"https://issuu.com/";"3007";"111";"662";"1322";"11519";"10";"16631"
"2018-05-28 12:03:20";"https://www.huffingtonpost.com/";"2747";"57";"3324";"5246";"13525";"75";"24974"
"2018-05-28 12:03:24";"http://www.stumbleupon.com/";"4779";"85";"553";"1186";"8147";"128";"14878"
"2018-05-28 12:03:35";"https://www.stumbleupon.com/";"1625";"95";"628";"3964";"1667";"90";"8069"
"2018-05-28 12:04:37";"https://aws.amazon.com/";"13707";"284";"8126";"7918";"6031";"23";"36089"
"2018-05-28 12:04:47";"https://www.parallels.com/";"16422";"271";"9456";"868";"24165";"30";"51212"
"2018-05-28 12:04:48";"https://www.google.co.uk/";"21735";"95";"15024";"684";"13192";"64";"50794"
"2018-05-28 12:05:03";"https://www.addtoany.com/";"14535";"32";"14871";"662";"19667";"3";"49770"
"2018-05-28 12:05:04";"https://www.dropbox.com/";"25093";"126";"16955";"359";"21246";"7";"63786"
"2018-05-28 12:05:16";"https://www.e-recht24.de/";"17778";"379";"15435";"3269";"1035";"542";"38438"
"2018-05-28 12:05:26";"https://www.opera.com/";"22082";"100";"16148";"748";"17420";"3";"56501"
"2018-05-28 12:05:49";"https://www.etsy.com/";"7139";"249";"16195";"13063";"1708";"1";"38355"
"2018-05-28 12:06:12";"https://www.bing.com/";"3022";"86";"322";"532";"247";"2";"4211"
"2018-05-28 12:06:51";"https://weibo.com/";"924";"676";"153";"1052";"11287";"20";"14112"
"2018-05-28 12:07:11";"https://www.bloomberg.com/";"737";"44";"382";"3534";"21497";"298";"26492"
"2018-05-28 12:07:18";"https://www.wikimedia.org/";"1132";"15";"547";"434";"697";"0";"2825"
"2018-05-28 12:07:29";"http://www.typepad.com/";"883";"113";"208";"1945";"1598";"1";"4748"
"2018-05-28 12:07:47";"http://www.dailymail.co.uk/";"170";"1631";"1413";"10847";"57053";"104";"71218"
"2018-05-28 12:08:06";"https://www.aol.com/";"1071";"204";"525";"10523";"31204";"737";"44264"
