"2018-06-24 23:41:13";"https://www.facebook.com/";"7624";"169";"264";"934";"3513";"278";"12782"
"2018-06-24 23:41:15";"https://twitter.com/";"365";"121";"418";"1675";"1052";"3";"3634"
"2018-06-24 23:41:17";"https://www.google.com/";"413";"91";"304";"1101";"2314";"87";"4310"
"2018-06-24 23:41:21";"https://www.youtube.com/";"268";"74";"638";"1805";"168";"2";"2955"
"2018-06-24 23:41:28";"https://www.linkedin.com/";"272";"202";"133";"1558";"295";"130";"2590"
"2018-06-24 23:41:33";"https://wordpress.org/";"273";"30";"114";"1187";"1145";"1";"2750"
"2018-06-24 23:41:39";"https://www.instagram.com/";"1501";"117";"246";"2539";"778";"18";"5199"
"2018-06-24 23:41:42";"https://www.pinterest.com/";"649";"267";"150";"696";"5449";"216";"7427"
"2018-06-24 23:41:49";"https://www.wikipedia.org/";"713";"40";"86";"3070";"245";"0";"4154"
"2018-06-24 23:41:52";"https://wordpress.com/";"1022";"50";"226";"2236";"2712";"368";"6614"
"2018-06-24 23:41:53";"https://www.blogger.com/";"2152";"46";"207";"1323";"583";"1";"4312"
"2018-06-24 23:42:03";"https://www.adobe.com/";"623";"36";"145";"2767";"4325";"354";"8250"
"2018-06-24 23:42:22";"https://www.apple.com/";"975";"37";"153";"4221";"560";"10";"5956"
"2018-06-24 23:42:26";"https://www.tumblr.com/";"940";"146";"416";"6959";"1257";"31";"9749"
"2018-06-24 23:42:28";"https://www.youtube.com/";"951";"79";"756";"3852";"151";"2";"5791"
"2018-06-24 23:42:37";"https://www.amazon.com/";"982";"115";"365";"2995";"1685";"21";"6163"
"2018-06-24 23:42:42";"https://goo.gl/";"637";"57";"123";"937";"861";"1";"2616"
"2018-06-24 23:42:53";"https://vimeo.com/";"614";"102";"87";"1652";"4928";"16";"7399"
"2018-06-24 23:42:56";"https://www.microsoft.com/";"2190";"306";"152";"1794";"749";"24";"5215"
"2018-06-24 23:43:17";"https://www.flickr.com/";"1115";"111";"69";"391";"8908";"13";"10607"
"2018-06-24 23:43:43";"https://www.godaddy.com/";"3071";"383";"2590";"567";"473";"39";"7123"
"2018-06-24 23:43:47";"https://www.yahoo.com/";"1305";"86";"1666";"1666";"23877";"105";"28705"
"2018-06-24 23:43:59";"https://www.buydomains.com/";"3891";"274";"925";"4186";"26485";"31";"35792"
"2018-06-24 23:44:03";"https://vk.com/";"2361";"235";"2687";"5085";"10816";"164";"21348"
"2018-06-24 23:44:03";"https://www.w3.org/";"6292";"78";"2155";"1297";"2034";"1";"11857"
"2018-06-24 23:44:06";"http://t.co/";"667";"122";"2889";"2";"203";"1";"3884"
"2018-06-24 23:44:07";"http://baidu.com/";"92";"79";"2813";"4";"23";"0";"3011"
"2018-06-24 23:44:08";"http://www.qq.com/";"1678";"315";"698";"7748";"33553";"3";"43995"
"2018-06-24 23:44:12";"http://www.baidu.com/";"1244";"525";"932";"2641";"251";"88";"5681"
"2018-06-24 23:44:23";"http://europa.eu/";"245";"157";"2640";"308";"2434";"3";"5787"
"2018-06-24 23:44:25";"https://www.nytimes.com/";"2999";"101";"2643";"8243";"17517";"75";"31578"
"2018-06-24 23:44:26";"https://www.gov.uk/";"2962";"33";"876";"1406";"675";"1";"5953"
"2018-06-24 23:44:28";"https://www.reddit.com/";"3552";"638";"3970";"984";"38483";"68";"47695"
"2018-06-24 23:44:50";"http://statcounter.com/";"138";"448";"2563";"4914";"2926";"0";"10989"
"2018-06-24 23:44:51";"https://www.weebly.com/";"1592";"124";"268";"2523";"11024";"2";"15533"
"2018-06-24 23:44:54";"https://www.blogger.com/";"4825";"34";"739";"1143";"418";"0";"7159"
"2018-06-24 23:45:16";"https://soundcloud.com/";"3848";"475";"665";"6035";"21412";"1";"32436"
"2018-06-24 23:45:16";"https://www.google.de/";"8669";"1580";"1310";"156";"3274";"15";"15004"
"2018-06-24 23:45:17";"https://www.mozilla.org/";"13945";"2431";"1180";"4208";"440";"4";"22208"
"2018-06-24 23:45:26";"https://github.com/";"2283";"11205";"953";"7127";"3942";"2";"25512"
"2018-06-24 23:45:36";"http://www.bbc.com/";"3474";"25";"3152";"22991";"9610";"969";"40221"
"2018-06-24 23:45:50";"https://www.jimdo.com/";"3520";"268";"1529";"3448";"14803";"5";"23573"
"2018-06-24 23:45:56";"https://myspace.com/";"5773";"156";"1894";"8188";"32278";"149";"48438"
"2018-06-24 23:45:58";"https://www.bluehost.com/";"3815";"493";"1990";"4531";"8366";"3";"19198"
"2018-06-24 23:46:30";"http://en.gravatar.com/";"2478";"119";"1003";"2203";"1045";"0";"6848"
"2018-06-24 23:46:32";"https://www.nih.gov/";"6854";"40";"1990";"2358";"3038";"15";"14295"
"2018-06-24 23:46:32";"https://www.addthis.com/";"2920";"126";"1393";"2033";"30236";"39";"36747"
"2018-06-24 23:46:33";"https://www.google.co.jp/";"11996";"89";"1823";"1166";"7896";"15";"22985"
"2018-06-24 23:46:35";"https://www.theguardian.com/";"8387";"136";"1956";"3711";"33495";"17";"47702"
"2018-06-24 23:46:38";"https://www.wix.com/";"5401";"230";"4999";"3187";"16180";"2";"29999"
"2018-06-24 23:46:41";"http://ascii.co.uk/";"253";"114";"3687";"2108";"21703";"26";"27891"
"2018-06-24 23:46:41";"https://www.paypal.com/";"6046";"482";"1441";"893";"1729";"30";"10621"
"2018-06-24 23:46:55";"https://outlook.live.com/";"2671";"206";"1431";"10595";"6181";"1";"21085"
"2018-06-24 23:47:01";"https://www.elegantthemes.com/";"3780";"67";"1675";"1457";"5754";"9";"12742"
"2018-06-24 23:47:32";"https://www.123-reg.co.uk/";"3199";"1";"4447";"2146";"3639";"368";"13800"
"2018-06-24 23:47:35";"https://www.tripadvisor.com/";"3467";"330";"843";"970";"5585";"17";"11212"
"2018-06-24 23:47:52";"http://www.stumbleupon.com/";"2930";"216";"619";"1892";"4614";"950";"11221"
"2018-06-24 23:48:02";"https://www.stumbleupon.com/";"518";"153";"1861";"2640";"1933";"134";"7239"
"2018-06-24 23:48:14";"https://issuu.com/";"3151";"75";"4691";"3345";"19755";"2";"31019"
"2018-06-24 23:49:00";"http://digg.com/";"187";"210";"4782";"6468";"46986";"228";"58861"
"2018-06-24 23:49:00";"https://www.google.co.uk/";"17483";"91";"19542";"943";"3026";"12";"41097"
"2018-06-24 23:49:22";"https://creativecommons.org/";"4405";"1";"17722";"10030";"38566";"1";"70725"
"2018-06-24 23:49:22";"https://www.msn.com/";"20335";"254";"13631";"4869";"530";"39";"39658"
"2018-06-24 23:49:22";"https://aws.amazon.com/";"11418";"74";"19270";"14652";"9507";"38";"54959"
"2018-06-24 23:49:28";"https://www.addtoany.com/";"13728";"43";"15184";"1094";"20947";"1";"50997"
"2018-06-24 23:49:38";"https://www.dropbox.com/";"23725";"1287";"14535";"1604";"22657";"33";"63841"
"2018-06-24 23:50:18";"https://cpanel.com/";"4203";"73";"365";"1049";"3475";"4";"9169"
"2018-06-24 23:50:53";"https://www.livejournal.com/";"1672";"178";"502";"5565";"31676";"383";"39976"
"2018-06-24 23:51:00";"https://www.reuters.com/";"1234";"188";"449";"9140";"34198";"551";"45760"
"2018-06-24 23:51:29";"https://www.wikimedia.org/";"3535";"744";"3522";"246";"5603";"1";"13651"
"2018-06-24 23:51:42";"https://weibo.com/";"1525";"914";"747";"2173";"53384";"198";"58941"
"2018-06-24 23:51:42";"http://www.typepad.com/";"3524";"438";"2561";"5785";"9903";"0";"22211"
