"2018-06-25 01:10:44";"https://www.facebook.com/";"2806";"168";"266";"1162";"2546";"64";"7012"
"2018-06-25 01:10:51";"https://twitter.com/";"324";"116";"49";"640";"924";"2";"2055"
"2018-06-25 01:10:52";"https://www.google.com/";"808";"85";"115";"830";"1033";"18";"2889"
"2018-06-25 01:10:59";"https://www.youtube.com/";"288";"116";"1498";"506";"246";"3";"2657"
"2018-06-25 01:11:10";"https://www.linkedin.com/";"281";"264";"97";"1483";"341";"113";"2579"
"2018-06-25 01:11:15";"https://wordpress.org/";"297";"89";"40";"476";"1813";"0";"2715"
"2018-06-25 01:11:22";"https://www.instagram.com/";"1266";"190";"136";"2839";"612";"14";"5057"
"2018-06-25 01:11:25";"https://www.pinterest.com/";"592";"308";"99";"702";"5475";"109";"7285"
"2018-06-25 01:11:32";"https://www.wikipedia.org/";"790";"86";"162";"1959";"110";"0";"3107"
"2018-06-25 01:11:37";"https://www.blogger.com/";"1366";"93";"216";"1020";"671";"0";"3366"
"2018-06-25 01:11:39";"https://wordpress.com/";"1096";"71";"932";"2499";"1958";"144";"6700"
"2018-06-25 01:11:46";"https://www.adobe.com/";"435";"0";"84";"2888";"1480";"145";"5032"
"2018-06-25 01:12:15";"https://www.tumblr.com/";"1024";"118";"350";"6153";"1001";"17";"8663"
"2018-06-25 01:12:15";"https://www.apple.com/";"572";"33";"1009";"8311";"330";"12";"10267"
"2018-06-25 01:12:19";"https://www.youtube.com/";"1345";"82";"559";"2560";"251";"9";"4806"
"2018-06-25 01:12:32";"https://www.amazon.com/";"757";"126";"340";"3111";"2752";"19";"7105"
"2018-06-25 01:12:37";"https://goo.gl/";"1174";"62";"226";"785";"1019";"1";"3267"
"2018-06-25 01:12:52";"https://vimeo.com/";"753";"128";"278";"2474";"6374";"42";"10049"
"2018-06-25 01:12:54";"https://www.microsoft.com/";"2143";"160";"516";"2557";"798";"56";"6230"
"2018-06-25 01:13:14";"https://www.flickr.com/";"1085";"167";"938";"125";"5890";"11";"8216"
"2018-06-25 01:13:44";"https://www.yahoo.com/";"1762";"84";"970";"5558";"14819";"145";"23338"
"2018-06-25 01:13:54";"https://www.godaddy.com/";"4186";"506";"3524";"916";"1111";"13";"10256"
"2018-06-25 01:14:07";"https://www.buydomains.com/";"7301";"305";"833";"2005";"27130";"37";"37611"
"2018-06-25 01:14:07";"https://vk.com/";"3810";"206";"3835";"7544";"6487";"169";"22051"
"2018-06-25 01:14:11";"https://www.w3.org/";"7133";"59";"1958";"1868";"4038";"0";"15056"
"2018-06-25 01:14:11";"http://www.qq.com/";"3213";"115";"1037";"8173";"27062";"1";"39601"
"2018-06-25 01:14:22";"http://t.co/";"634";"132";"4284";"96";"80";"0";"5226"
"2018-06-25 01:14:23";"http://baidu.com/";"219";"175";"3592";"4";"110";"1";"4101"
"2018-06-25 01:14:28";"http://www.baidu.com/";"1046";"266";"2008";"2339";"537";"3";"6199"
"2018-06-25 01:14:30";"https://www.nytimes.com/";"3279";"43";"1542";"11649";"13066";"48";"29627"
"2018-06-25 01:14:38";"http://europa.eu/";"60";"10";"2954";"1381";"1186";"7";"5598"
"2018-06-25 01:14:39";"https://www.reddit.com/";"5694";"699";"4622";"942";"38879";"24";"50860"
"2018-06-25 01:14:42";"https://www.gov.uk/";"3882";"28";"336";"1714";"527";"1";"6488"
"2018-06-25 01:15:11";"https://www.weebly.com/";"5675";"221";"4075";"1574";"5190";"7";"16742"
"2018-06-25 01:15:12";"http://statcounter.com/";"92";"151";"2916";"7054";"5523";"1";"15737"
"2018-06-25 01:15:16";"https://www.blogger.com/";"5825";"80";"619";"1756";"527";"1";"8808"
"2018-06-25 01:15:26";"https://soundcloud.com/";"4883";"153";"1115";"7455";"6306";"1";"19913"
"2018-06-25 01:15:38";"https://www.google.de/";"4170";"169";"789";"1626";"3096";"96";"9946"
"2018-06-25 01:15:38";"https://www.mozilla.org/";"9242";"29";"1268";"6253";"427";"454";"17673"
"2018-06-25 01:15:41";"https://github.com/";"2629";"470";"2760";"8180";"5428";"2";"19469"
"2018-06-25 01:15:55";"http://www.bbc.com/";"6093";"31";"3035";"11100";"19922";"130";"40311"
"2018-06-25 01:16:13";"https://yandex.ru/";"4237";"291";"3839";"8692";"3290";"11";"20360"
"2018-06-25 01:16:25";"https://myspace.com/";"4927";"248";"2244";"13350";"26327";"199";"47295"
"2018-06-25 01:16:26";"https://www.jimdo.com/";"3932";"190";"2061";"3461";"25598";"6";"35248"
"2018-06-25 01:16:31";"https://www.bluehost.com/";"4645";"509";"5614";"1578";"7059";"2";"19407"
"2018-06-25 01:16:38";"https://wordpress.com/";"9529";"55";"6146";"899";"12310";"115";"29054"
"2018-06-25 01:17:12";"https://www.addthis.com/";"4881";"125";"1612";"1702";"32499";"746";"41565"
"2018-06-25 01:17:12";"https://www.google.co.jp/";"13189";"87";"4662";"991";"4351";"17";"23297"
"2018-06-25 01:17:12";"http://en.gravatar.com/";"4172";"88";"4029";"2630";"257";"1";"11177"
"2018-06-25 01:17:15";"https://www.nih.gov/";"9132";"52";"10377";"1108";"717";"9";"21395"
"2018-06-25 01:17:15";"https://www.theguardian.com/";"11258";"27";"961";"5882";"37244";"6";"55378"
"2018-06-25 01:17:19";"https://www.wix.com/";"8282";"47";"4270";"5309";"15578";"2";"33488"
"2018-06-25 01:17:22";"https://www.paypal.com/";"8691";"280";"1347";"1668";"1035";"84";"13105"
"2018-06-25 01:17:23";"http://ascii.co.uk/";"471";"114";"5292";"5149";"20635";"377";"32038"
"2018-06-25 01:17:25";"https://outlook.live.com/";"3393";"66";"1497";"5433";"2074";"1";"12464"
"2018-06-25 01:17:44";"https://www.elegantthemes.com/";"6841";"293";"800";"2562";"3671";"45";"14212"
"2018-06-25 01:17:47";"https://www.cnn.com/";"13874";"43";"1270";"8130";"21505";"387";"45209"
"2018-06-25 01:18:22";"https://www.123-reg.co.uk/";"4480";"1";"4562";"514";"6524";"286";"16367"
"2018-06-25 01:18:23";"https://www.tripadvisor.com/";"4203";"295";"741";"763";"7235";"5";"13242"
"2018-06-25 01:18:46";"http://www.stumbleupon.com/";"3510";"83";"329";"1995";"8394";"468";"14779"
"2018-06-25 01:18:51";"https://issuu.com/";"3508";"76";"4261";"1454";"13670";"13";"22982"
"2018-06-25 01:18:57";"https://www.stumbleupon.com/";"341";"91";"291";"3691";"1963";"70";"6447"
"2018-06-25 01:19:39";"https://www.huffingtonpost.com/";"4017";"25";"7180";"5888";"40347";"26";"57483"
"2018-06-25 01:20:03";"https://www.opera.com/";"2939";"54";"543";"658";"4916";"5";"9115"
"2018-06-25 01:20:21";"https://www.washingtonpost.com/";"426";"1797";"170";"2899";"9996";"1457";"16745"
"2018-06-25 01:20:35";"https://www.etsy.com/";"583";"715";"114";"6913";"9751";"2";"18078"
"2018-06-25 01:20:41";"https://archive.org/";"569";"407";"230";"3258";"1050";"5";"5519"
"2018-06-25 01:20:50";"https://www.eventbrite.com/";"858";"1084";"531";"6294";"6381";"193";"15341"
"2018-06-25 01:20:51";"https://cpanel.com/";"1520";"64";"144";"930";"3695";"4";"6357"
"2018-06-25 01:20:57";"https://www.xing.com/";"564";"297";"122";"2502";"2066";"1";"5552"
"2018-06-25 01:21:23";"https://ameblo.jp/";"2114";"226";"5044";"6943";"1209";"0";"15536"
"2018-06-25 01:21:23";"https://fc2.com/";"2883";"200";"1502";"1438";"2476";"44";"8543"
"2018-06-25 01:21:28";"https://sourceforge.net/";"1487";"354";"1846";"4402";"17851";"386";"26326"
"2018-06-25 01:21:35";"http://www.free.fr/";"4686";"73";"2940";"7039";"1138";"0";"15876"
"2018-06-25 01:21:40";"https://www.ebay.com/";"4003";"126";"2057";"5474";"13244";"92";"24996"
"2018-06-25 01:21:42";"https://www.bing.com/";"6741";"506";"4127";"551";"885";"1";"12811"
"2018-06-25 01:21:48";"https://www.amazon.co.uk/";"5646";"555";"3263";"8971";"22171";"42";"40648"
"2018-06-25 01:21:55";"https://cpanel.com/";"4226";"915";"5715";"2682";"9801";"13";"23352"
"2018-06-25 01:23:05";"https://www.wikimedia.org/";"14165";"243";"2438";"74";"2846";"0";"19766"
"2018-06-25 01:23:11";"https://www.livejournal.com/";"6830";"633";"2932";"8390";"73338";"506";"92629"
"2018-06-25 01:23:15";"http://www.typepad.com/";"4628";"429";"2882";"4002";"7207";"0";"19148"
"2018-06-25 01:23:47";"https://weibo.com/";"11511";"1466";"1634";"7876";"70911";"166";"93564"
