"2018-05-26 09:43:34";"https://www.facebook.com/";"2262";"344";"350";"1090";"1124";"27";"5197"
"2018-05-26 09:43:41";"https://twitter.com/";"345";"140";"224";"816";"812";"2";"2339"
"2018-05-26 09:43:42";"https://www.google.com/";"498";"88";"221";"706";"922";"22";"2457"
"2018-05-26 09:43:49";"https://www.youtube.com/";"266";"91";"1187";"625";"2228";"2";"4399"
"2018-05-26 09:43:57";"https://www.linkedin.com/";"336";"472";"117";"1641";"386";"110";"3062"
"2018-05-26 09:44:04";"https://wordpress.org/";"573";"88";"387";"1221";"2554";"1";"4824"
"2018-05-26 09:44:09";"https://www.instagram.com/";"813";"527";"411";"2667";"541";"25";"4984"
"2018-05-26 09:44:19";"https://www.pinterest.com/";"1239";"248";"120";"919";"9023";"368";"11917"
"2018-05-26 09:44:20";"https://www.wikipedia.org/";"1097";"52";"460";"3367";"402";"0";"5378"
"2018-05-26 09:44:28";"https://www.blogger.com/";"7361";"35";"356";"1365";"429";"1";"9547"
"2018-05-26 09:44:30";"https://wordpress.com/";"1043";"47";"1378";"2922";"7227";"362";"12979"
"2018-05-26 09:44:35";"https://www.adobe.com/";"649";"0";"307";"4535";"4981";"252";"10724"
"2018-05-26 09:44:53";"https://www.apple.com/";"481";"47";"1015";"5702";"987";"55";"8287"
"2018-05-26 09:44:56";"https://www.tumblr.com/";"910";"132";"341";"8485";"1245";"12";"11125"
"2018-05-26 09:45:05";"https://www.youtube.com/";"1291";"73";"734";"4950";"7643";"10";"14701"
"2018-05-26 09:45:08";"https://www.amazon.com/";"896";"116";"609";"4079";"2388";"50";"8138"
"2018-05-26 09:45:13";"https://goo.gl/";"1162";"67";"613";"1362";"2561";"3";"5768"
"2018-05-26 09:45:22";"https://www.microsoft.com/";"1155";"190";"295";"1857";"660";"16";"4173"
"2018-05-26 09:45:34";"https://vimeo.com/";"5185";"150";"415";"5829";"5425";"46";"17050"
"2018-05-26 09:45:44";"https://www.flickr.com/";"925";"210";"408";"485";"6981";"32";"9041"
"2018-05-26 09:46:13";"https://www.godaddy.com/";"2472";"172";"3477";"1234";"2088";"66";"9509"
"2018-05-26 09:46:14";"https://www.yahoo.com/";"1335";"75";"1360";"6009";"22321";"20";"31120"
"2018-05-26 09:46:18";"https://www.buydomains.com/";"5747";"321";"1260";"3447";"12138";"30";"22943"
"2018-05-26 09:46:25";"https://vk.com/";"3030";"200";"3376";"7891";"4229";"68";"18794"
"2018-05-26 09:46:26";"http://www.qq.com/";"1835";"51";"1594";"8861";"19096";"1";"31438"
"2018-05-26 09:46:29";"https://www.w3.org/";"3881";"0";"3319";"1277";"2890";"1";"11368"
"2018-05-26 09:46:33";"http://t.co/";"498";"193";"1902";"73";"506";"1";"3173"
"2018-05-26 09:46:36";"http://baidu.com/";"30";"3";"1803";"82";"86";"2";"2006"
"2018-05-26 09:46:41";"https://www.baidu.com/";"907";"306";"132";"2385";"487";"16";"4233"
"2018-05-26 09:46:45";"https://www.reddit.com/";"4567";"817";"3425";"2937";"23743";"14";"35503"
"2018-05-26 09:46:49";"http://europa.eu/";"122";"100";"1900";"622";"2795";"3";"5542"
"2018-05-26 09:46:53";"https://www.nytimes.com/";"2257";"42";"1331";"15599";"13434";"39";"32702"
"2018-05-26 09:46:55";"https://www.gov.uk/";"4553";"0";"143";"1876";"523";"1";"7096"
"2018-05-26 09:47:16";"http://statcounter.com/";"92";"641";"2738";"3022";"2587";"2";"9082"
"2018-05-26 09:47:17";"https://www.weebly.com/";"1417";"141";"296";"4458";"9093";"2";"15407"
"2018-05-26 09:47:20";"https://www.blogger.com/";"4250";"248";"714";"1700";"596";"5";"7513"
"2018-05-26 09:47:38";"http://www.bbc.com/";"454";"44";"71";"8261";"9103";"101";"18034"
"2018-05-26 09:47:39";"https://soundcloud.com/";"2115";"229";"884";"3976";"20975";"1";"28180"
"2018-05-26 09:47:41";"https://github.com/";"2976";"122";"2574";"5453";"2381";"2";"13508"
"2018-05-26 09:47:42";"https://www.google.de/";"2950";"275";"1596";"1210";"4671";"97";"10799"
"2018-05-26 09:47:42";"https://www.mozilla.org/";"782";"229";"3144";"899";"2094";"7";"7155"
"2018-05-26 09:48:06";"https://www.jimdo.com/";"1265";"119";"780";"2327";"13024";"0";"17515"
"2018-05-26 09:48:17";"https://www.bluehost.com/";"3019";"414";"422";"4462";"3556";"9";"11882"
"2018-05-26 09:48:19";"https://wordpress.com/";"6057";"92";"669";"822";"11001";"275";"18916"
"2018-05-26 09:48:24";"https://www.addthis.com/";"1985";"108";"534";"1932";"3756";"255";"8570"
"2018-05-26 09:48:45";"https://www.google.co.jp/";"6491";"97";"4845";"668";"3624";"91";"15816"
"2018-05-26 09:48:45";"http://en.gravatar.com/";"1775";"91";"862";"2455";"1011";"0";"6194"
"2018-05-26 09:48:50";"https://www.nih.gov/";"4666";"57";"1399";"5285";"1954";"48";"13409"
"2018-05-26 09:48:54";"http://ascii.co.uk/";"215";"106";"2476";"1680";"8537";"76";"13090"
"2018-05-26 09:48:58";"https://www.wix.com/";"8315";"99";"1462";"4441";"10529";"207";"25053"
"2018-05-26 09:49:02";"https://www.paypal.com/";"4292";"225";"625";"841";"1752";"41";"7776"
"2018-05-26 09:49:04";"https://outlook.live.com/";"1373";"511";"1364";"4329";"1061";"1";"8639"
"2018-05-26 09:49:18";"https://www.elegantthemes.com/";"2091";"56";"849";"1932";"1607";"14";"6549"
"2018-05-26 09:49:51";"https://www.123-reg.co.uk/";"1464";"0";"732";"775";"4764";"914";"8649"
"2018-05-26 09:49:52";"https://www.tripadvisor.com/";"1503";"306";"798";"800";"3919";"21";"7347"
"2018-05-26 09:50:11";"https://issuu.com/";"1592";"579";"1107";"2540";"6802";"10";"12630"
"2018-05-26 09:50:16";"http://www.stumbleupon.com/";"4035";"80";"384";"1164";"3911";"243";"9817"
"2018-05-26 09:50:24";"https://www.stumbleupon.com/";"59";"85";"509";"3005";"1762";"70";"5490"
"2018-05-26 09:50:53";"https://creativecommons.org/";"3008";"6";"1486";"14506";"6851";"2";"25859"
"2018-05-26 09:51:10";"https://www.google.co.uk/";"7780";"221";"2466";"1183";"11253";"62";"22965"
"2018-05-26 09:51:12";"https://aws.amazon.com/";"3618";"189";"2924";"11891";"3149";"6";"21777"
"2018-05-26 09:51:16";"https://www.dropbox.com/";"7381";"397";"2168";"898";"17765";"11";"28620"
"2018-05-26 09:51:16";"https://www.parallels.com/";"10110";"265";"1725";"3690";"21494";"3";"37287"
"2018-05-26 09:51:37";"https://www.opera.com/";"4576";"146";"2324";"1253";"1230";"6188";"15717"
"2018-05-26 09:51:42";"https://www.addtoany.com/";"15898";"42";"1410";"559";"17385";"1";"35295"
"2018-05-26 09:51:43";"https://www.e-recht24.de/";"8637";"462";"6812";"4847";"2988";"600";"24346"
"2018-05-26 09:52:33";"https://www.etsy.com/";"3885";"334";"6004";"23266";"1654";"1";"35144"
"2018-05-26 09:52:41";"https://archive.org/";"8475";"362";"25804";"1633";"909";"17";"37200"
"2018-05-26 09:53:23";"https://cpanel.com/";"34603";"64";"19099";"1650";"5698";"5";"61119"
"2018-05-26 09:53:23";"http://www.free.fr/";"16100";"0";"5409";"5689";"432";"0";"27630"
"2018-05-26 09:53:23";"https://www.ebay.com/";"17278";"151";"8363";"6734";"650";"91";"33267"
"2018-05-26 09:53:24";"https://ameblo.jp/";"15415";"224";"17516";"7544";"1185";"1";"41885"
"2018-05-26 09:53:28";"https://cpanel.com/";"11601";"0";"15258";"601";"1783";"4";"29247"
"2018-05-26 09:53:41";"https://www.forbes.com/";"2955";"106";"7275";"2550";"96059";"316";"109261"
"2018-05-26 09:53:44";"https://www.bing.com/";"18225";"1150";"28255";"3091";"137";"30";"50888"
"2018-05-26 09:53:52";"https://www.amazon.co.uk/";"24267";"165";"7034";"18798";"21977";"63";"72304"
"2018-05-26 09:54:08";"https://www.wikimedia.org/";"11672";"363";"2950";"166";"8037";"1";"23189"
"2018-05-26 09:54:23";"https://www.livejournal.com/";"12022";"532";"16937";"13037";"52696";"209";"95433"
"2018-05-26 09:54:28";"https://weibo.com/";"33354";"1027";"2140";"4423";"26522";"31";"67497"
"2018-05-26 09:54:34";"http://www.typepad.com/";"4984";"319";"1765";"13290";"22452";"80";"42890"
"2018-05-26 09:54:36";"https://www.reuters.com/";"14011";"519";"28872";"30057";"36468";"291";"110218"
