2018-06-05 10:17:13,https://www.facebook.com/,2449,577,152,868,1583,41,5670
2018-06-05 10:17:22,https://twitter.com/,257,427,489,1139,907,1,3220
2018-06-05 10:17:23,https://www.google.com/,266,95,296,751,1445,61,2914
2018-06-05 10:17:30,https://www.youtube.com/,246,58,499,1628,370,3,2804
2018-06-05 10:17:49,https://www.linkedin.com/,247,4658,231,3218,1162,345,9861
2018-06-05 10:17:51,https://wordpress.org/,330,34,337,1510,3371,0,5582
2018-06-05 10:17:55,https://www.instagram.com/,1848,189,218,2296,375,16,4942
2018-06-05 10:17:59,https://www.pinterest.com/,754,158,99,650,5037,135,6833
2018-06-05 10:18:06,https://www.wikipedia.org/,728,35,421,3099,129,0,4412
2018-06-05 10:18:09,https://www.blogger.com/,1692,43,298,1048,695,0,3776
2018-06-05 10:18:10,https://wordpress.com/,901,57,420,627,4333,412,6750
2018-06-05 10:18:27,https://www.adobe.com/,367,33,421,5638,5650,442,12551
2018-06-05 10:18:46,https://www.apple.com/,497,30,670,5287,1409,19,7912
2018-06-05 10:18:47,https://www.tumblr.com/,603,101,345,7132,1482,39,9702
2018-06-05 10:18:50,https://www.youtube.com/,1058,73,528,3034,404,21,5118
2018-06-05 10:19:02,https://www.amazon.com/,545,116,334,2288,2878,67,6228
2018-06-05 10:19:06,https://goo.gl/,563,57,462,1194,627,1,2904
2018-06-05 10:19:23,https://vimeo.com/,484,113,266,2434,5757,28,9082
2018-06-05 10:19:23,https://www.microsoft.com/,1420,175,299,2367,1250,13,5524
2018-06-05 10:19:47,https://www.flickr.com/,856,83,326,361,7924,74,9624
2018-06-05 10:20:14,https://www.buydomains.com/,2131,1316,1264,1845,10496,85,17137
2018-06-05 10:20:18,https://www.godaddy.com/,1879,502,1143,770,2710,16,7020
2018-06-05 10:20:21,https://vk.com/,766,174,767,3773,2062,112,7654
2018-06-05 10:20:24,http://www.qq.com/,3922,67,230,8011,11753,1,23984
2018-06-05 10:20:34,https://www.w3.org/,3312,205,477,985,2100,0,7079
2018-06-05 10:20:42,http://t.co/,127,45,1329,79,69,0,1649
2018-06-05 10:20:49,https://www.reddit.com/,1614,1285,5320,3428,17807,11,29465
2018-06-05 10:20:50,http://baidu.com/,33,1,1157,43,81,1,1316
2018-06-05 10:20:52,http://www.baidu.com/,421,253,316,1311,426,27,2754
2018-06-05 10:21:03,https://www.nytimes.com/,1944,45,680,14102,14151,51,30973
2018-06-05 10:21:05,http://europa.eu/,36,200,1161,747,2670,2,4816
2018-06-05 10:21:10,https://www.gov.uk/,1004,1,480,1375,961,1,3822
2018-06-05 10:21:36,http://statcounter.com/,70,280,2368,3560,2065,0,8343
2018-06-05 10:21:37,https://www.weebly.com/,1288,144,287,3799,7458,15,12991
2018-06-05 10:21:40,https://www.blogger.com/,3656,39,525,1468,455,1,6144
2018-06-05 10:21:53,https://soundcloud.com/,3275,159,643,3881,12343,2,20303
2018-06-05 10:22:00,https://www.mozilla.org/,4008,46,805,2524,1459,1,8843
2018-06-05 10:22:02,https://github.com/,1390,124,977,6394,1746,3,10634
2018-06-05 10:22:03,http://www.bbc.com/,608,22,806,10673,12747,39,24895
2018-06-05 10:22:07,https://www.google.de/,4473,145,1862,914,3249,100,10743
2018-06-05 10:22:33,https://www.jimdo.com/,1983,28,757,2296,8458,1,13523
2018-06-05 10:22:33,https://myspace.com/,1285,267,976,7476,20046,158,30208
2018-06-05 10:22:47,https://www.bluehost.com/,1987,420,925,4099,1349,23,8803
2018-06-05 10:22:51,https://wordpress.com/,5491,47,827,3450,7511,243,17569
2018-06-05 10:22:57,https://www.addthis.com/,1246,1,634,1261,4303,262,7707
2018-06-05 10:23:20,https://www.google.co.jp/,2321,157,5097,1159,3663,31,12428
2018-06-05 10:23:21,https://www.theguardian.com/,4756,34,502,5746,22082,5,33125
2018-06-05 10:23:26,http://en.gravatar.com/,2041,82,1039,3041,1254,1,7458
2018-06-05 10:23:28,https://www.nih.gov/,4906,45,3906,3185,3326,34,15402
2018-06-05 10:23:30,https://www.wix.com/,2347,108,4943,3640,9841,3,20882
2018-06-05 10:23:30,http://ascii.co.uk/,172,117,2697,1724,8591,21,13322
2018-06-05 10:23:42,https://www.paypal.com/,4132,370,1060,856,1999,48,8465
2018-06-05 10:23:42,https://outlook.live.com/,1503,96,784,3877,751,0,7011
2018-06-05 10:24:04,https://www.elegantthemes.com/,1623,148,548,765,2669,1,5754
2018-06-05 10:24:12,https://www.cnn.com/,4120,35,1805,9850,24730,203,40743
2018-06-05 10:24:40,https://www.123-reg.co.uk/,1592,135,295,2187,2640,529,7378
2018-06-05 10:24:46,https://www.tripadvisor.com/,2096,471,407,679,4050,74,7777
2018-06-05 10:25:07,https://issuu.com/,2759,109,628,1554,7743,2,12795
2018-06-05 10:25:12,http://www.stumbleupon.com/,3893,80,335,907,3374,265,8854
2018-06-05 10:25:15,https://www.huffingtonpost.com/,1498,28,852,2739,19611,66,24794
2018-06-05 10:25:19,https://www.stumbleupon.com/,43,86,333,1394,2417,398,4671
2018-06-05 10:25:48,https://creativecommons.org/,2872,413,514,5201,10912,19,19931
2018-06-05 10:25:54,https://www.google.co.uk/,7015,165,927,93,2854,12,11066
2018-06-05 10:26:17,https://aws.amazon.com/,3052,99,2309,11150,7277,8,23895
2018-06-05 10:26:19,https://www.dropbox.com/,4826,162,1517,424,19899,11,26839
2018-06-05 10:26:22,https://www.parallels.com/,8561,212,1057,1064,28652,4,39550
2018-06-05 10:26:25,https://www.imdb.com/,6376,259,6933,7423,28280,47,49318
2018-06-05 10:26:29,https://www.yelp.com/,5122,553,1649,13091,23404,3,43822
2018-06-05 10:26:39,https://www.addtoany.com/,14877,34,680,195,7648,1,23435
2018-06-05 10:26:40,https://www.msn.com/,9933,230,2098,6650,1017,37,19965
2018-06-05 10:26:42,https://www.e-recht24.de/,4869,895,2102,6160,3707,597,18330
2018-06-05 10:26:43,https://www.opera.com/,4570,187,1560,909,16236,2,23464
2018-06-05 10:27:12,https://www.etsy.com/,3106,426,1276,13245,7142,1,25196
2018-06-05 10:27:20,https://archive.org/,3010,286,913,2805,2809,40,9863
2018-06-05 10:27:25,https://www.eventbrite.com/,5364,457,966,6284,6642,47,19760
2018-06-05 10:27:30,https://cpanel.com/,8333,60,749,388,2328,4,11862
2018-06-05 10:27:46,https://www.xing.com/,2388,406,3880,4592,11737,2,23005
2018-06-05 10:28:02,https://fc2.com/,3347,118,3239,1747,2718,4,11173
2018-06-05 10:28:03,https://www.ebay.com/,4845,180,4723,5279,636,60,15723
2018-06-05 10:28:11,https://ameblo.jp/,6874,195,6572,6507,5201,0,25349
2018-06-05 10:28:11,http://www.free.fr/,4249,293,7477,2799,1004,0,15822
2018-06-05 10:28:26,https://www.amazon.co.uk/,9256,570,7640,13874,15929,84,47353
2018-06-05 10:28:27,https://www.bing.com/,24555,256,2760,1969,417,2,29959
2018-06-05 10:28:38,https://cpanel.com/,13840,299,2871,1458,4569,4,23041
2018-06-05 10:29:13,https://www.telegraph.co.uk/,11804,80,3035,10240,71383,963,97505
2018-06-05 10:29:40,https://www.wikimedia.org/,18471,40,2114,366,2787,0,23778
2018-06-05 10:29:41,https://www.bloomberg.com/,6426,780,2092,2314,41905,213,53730
2018-06-05 10:29:41,http://www.typepad.com/,3443,121,836,1629,5449,0,11478
